static const chatChatDetail = '/chat_chat_detail';
static const chatForwardContact = '/chat_forward_contact';
static const chatForwardConversation = '/chat_forward_conversation';
static const chatForwardGroup = '/chat_forward_group';
static const chat = '/chat';
static const chatWidgetsChatInputWidget = '/chat_widgets_chat_input_widget';
static const contactsContactsAddFriend = '/contacts_contacts_add_friend';
static const contactsContactsUpdateRemark = '/contacts_contacts_update_remark';
static const contactsContactsUserDetail = '/contacts_contacts_user_detail';
static const contactsContactsFriendApplyList = '/contacts_contacts_friend_apply_list';
static const contactsContacts = '/contacts_contacts';
static const contactsContactsSelectContacts = '/contacts_contacts_select_contacts';
static const conversationsConversations = '/conversations_conversations';
static const groupMyGroupChangeGroupNick = '/group_my_group_change_group_nick';
static const groupMyGroupGroupDetail = '/group_my_group_group_detail';
static const groupMyGroupGroupManageGroupMemberSettingGroupManagerSetting = '/group_my_group_group_manage_group_member_setting_group_manager_setting';
static const groupMyGroupGroupManageGroupMemberSettingGroupMuteSetting = '/group_my_group_group_manage_group_member_setting_group_mute_setting';
static const groupMyGroupGroupManageGroupMemberSetting = '/group_my_group_group_manage_group_member_setting';
static const groupMyGroupGroupManage = '/group_my_group_group_manage';
static const groupMyGroup = '/group_my_group';
static const groupMyGroupSetGroupAvatar = '/group_my_group_set_group_avatar';
static const groupMyGroupSetGroupName = '/group_my_group_set_group_name';
static const groupMyGroupSetGroupNotice = '/group_my_group_set_group_notice';
static const groupMyGroupShowGroupNotice = '/group_my_group_show_group_notice';
static const mineAboutUs = '/mine_about_us';
static const mineAccountSafetyChangePassword = '/mine_account_safety_change_password';
static const mineAccountSafety = '/mine_account_safety';
static const mineMessageNotification = '/mine_message_notification';
static const mineUserInfomationChangeNickname = '/mine_user_infomation_change_nickname';
static const mineUserInfomationMyQrCode = '/mine_user_infomation_my_qr_code';
static const mineUserInfomation = '/mine_user_infomation';
static const mineVersionCheck = '/mine_version_check';
static const mineMine = '/mine_mine';
static const minePrivacySetting = '/mine_privacy_setting';
static const stylesButtons = '/styles_buttons';
static const stylesIcon = '/styles_icon';
static const stylesImage = '/styles_image';
static const stylesInputs = '/styles_inputs';
static const stylesStyleIndex = '/styles_style_index';
static const stylesText = '/styles_text';
static const systemLogin = '/system_login';
static const systemMain = '/system_main';
static const systemQrcodeScanner = '/system_qrcode_scanner';
static const systemRegister = '/system_register';
static const systemSplash = '/system_splash';
